R 500 450





NO /home/user42/Bureau/42/cub3d/texture/wood.xpm






SO /home/user42/Bureau/42/cub3d/texture/redbrick.xpm
WE /home/user42/Bureau/42/cub3d/texture/purplestone.xpm

EA /home/user42/Bureau/42/cub3d/texture/colorstone.xpm
S /home/user42/Bureau/42/cub3d/sprite/pillar.xpm








F 255,255,255

C 225,30,0





111111111111111111
100000000000000001
100000000000000001
100000000S00000001
100000000000000001
100000000000000001
100000000002100001
100000200001100001
100000000000000001
100000002000020001
100000000100000001
100000000000000001
100020000002000001
100000000000000001
100000000000000001
100002000200000001
100001001100000001
100000200000000001
111111111111111111
