R 700 700
NO ./path_to_the_north_texture
SO ./path_to_the_south_texture
WE ./path_to_the_west_texture
EA ./path_to_the_east_texture
S ./path_to_the_sprite_texture
F 255,255,255
C 225,30,0


111111111111111111111
100000000100000000001
111011110101111111111
1N0030330100010001011
131110110101010101011
100000000001000100011
101111111111111111111
100000000000000000011
131111111111111111011
102220000000000000001
102420000000000000001
102220000000000000001
111111111111111111111
