R 1000 1000
NO ./path_to_the_north_texture
SO ./path_to_the_south_texture
WE ./path_to_the_west_texture
EA ./path_to_the_east_texture
S ./path_to_the_sprite_texture
F 255,255,255
C 225,30,0


1111111111111111111111
1W00000001000000000011
1310111101011111111111
1000303301000100010111
1311101101010101010111
1000000000100010001111
1311111111111111111111
1000000000000000000011
1111111111111111111111
