R 500 400
NO ./path_to_the_north_texture
SO ./path_to_the_south_texture
WE ./path_to_the_west_texture
EA ./path_to_the_east_texture
S ./path_to_the_sprite_texture
F 255,255,255
C 225,30,0


          111111111111111111111   11111
          100000000000000000001   10001
111111111110111111111111111111111111111   11
1N0030330100010001011                     11 
131110110101010101011
100000000001000100011
101111111111111111111        1111111111
100000000000000000011        1000000001
131111111111111111011        1000000001
102220000000000000001        1000000001   
102420000000000000001        1000000001
102220000000000000001        1111111111
111111111111111111111


111111111111111111111111111111111111111
100000000000000000000000000000000000001
111111111111111111111111111111111111111
