R 500 400
NO /home/user42/Bureau/42/cub3d/texture/eagle.xpm
SO /home/user42/Bureau/42/cub3d/texture/lego_wall.xpm
WE /home/user42/Bureau/42/cub3d/texture/lego_wall.xpm
EA /home/user42/Bureau/42/cub3d/sprite/mario_flower.xpm
S /home/user42/Bureau/42/cub3d/sprite/mario_flower.xpm
F 255,255,255
C 225,30,0


          111111111111111111111   11111
          100000000000000000001   10001
111111111110111111111111111111111111111   11
100030330100010001011                     11 
131110110101010101011
100000000001000100011
101111111111111111111        1111111111
100000000000000000011        1000000001
131111111111111111011        1000000001
102220000000000000001        1000000001   
102420000000000W00001        1000000001
102220000000000000001        1111111111
111111111111111111111


111111111111111111111111111111111111111
100000000000000000000000000000000000001
111111111111111111111111111111111111111
