R 500 450





NO /home/user42/Bureau/42/cub3d/texture/wood.xpm






SO /home/user42/Bureau/42/cub3d/texture/redbrick.xpm
WE /home/user42/Bureau/42/cub3d/texture/purplestone.xpm

EA /home/user42/Bureau/42/cub3d/texture/colorstone.xpm
S /home/user42/Bureau/42/cub3d/sprite/pillar.xpm








F 255,255,255

C 225,30,0





111111111111111111
100000200000000001
100000000000020001
100020000S00000001
122222222222222221
122222222222222221
122222222222222221
122222222222222221
122222222222222221
122222222222222221
122222222222222221
122222222222222221
122222222222222221
122222222222222221
122222222222222221
122222222222222221
122222222222222221
122222222222222221
111111111111111111
