R 500 450





NO /home/user42/Bureau/42/cub3d/texture/wood.xpm






SO /home/user42/Bureau/42/cub3d/texture/redbrick.xpm
WE /home/user42/Bureau/42/cub3d/texture/purplestone.xpm

EA /home/user42/Bureau/42/cub3d/texture/colorstone.xpm
S /home/user42/Bureau/42/cub3d/texture/colorstone.xpm








F 255,255,255

C 225,30,0





111111111111111111
100000000000000001
100000000000000001
100000000S00200001
100000000000000001
100200000000200001
100000000000000001
100200202000000001
100000000000000001
100000000000000001
100000200200000001
100000000000000001
100000000000000001
100000000000000001
100000000000000001
100000000000000001
100000000000000001
100000000000000001
111111111111111111
