R 500 400
NO ./path_to_the_north_texture
SO ./path_to_the_south_texture
WE ./path_to_the_west_texture
EA ./path_to_the_east_texture
S ./path_to_the_sprite_texture
F 255,255,255
C 225,30,0

                                                       11111111
                                                       10000001
                                                       10000001
                                                       11111111
            1111111
            1000001
            1000001
            1111111





                       11111111111111111111111111
                       10000000000000000000000001
                       10000000000000000000000001
                       10000000000000000000000001
                       10000000000000000000000001
                       10000000000N00000000000001            1111
                       10000000000000000000000001            1001
                       10000000000000000000000001            1001
                       11111111111111111111111111            1111


            

1111
1001
1001           111
1001           101
1111           111                                                                      111111
                                                                                        100001
                                                                                        111111


                                                11111
                                                10001
                                                10001
                                                11111
