111111111111111111111111111111111111111111111111111111111111111111
100000000000000000000000000000000000000000000000000000000000000001
100000000000000000000000000000000000000000000000000000000000000001
1000000000000000000000000000000S0000000000000000000000000000000001
100000000000000000000000000000000000000000000000000000000000000001
100000000000000000000000000000000000000000000000000000000000000001
100000000000000000000000000000020000000000000000000000000000000001
100000000000000000000000011111111111110000000000000000000000000001
100000000000000000000000111111111111111000000000000000000000000001
100000000000000000000001111111111111111100000000000000000000000001
100000000000000000000011111111111111111110000000000000000000000001
100000000000000000000011111111111111111110000000000000000000000001
100000000000000000000011111111111111111110000000000000000000000001
100000000000000000000011111111111111111110000000000000000000000001
100000000000000000000001111111111111111100000000000000000000000001
100000000000000000000000111111111111111000000000000000000000000001
100000000000000000000000000000000000000000000000000000000000000001
100001111000000000000000000000000000000000000000000000000111100001
100001111000000000000000000000000000000000000000000000000111100001
100001111000000000000000000000000000000000000000000000000111100001
100001111000000000000000000000000000000000000000000000000111100001
100000000000000000000000000000000000000000000000000000000000000001
111111111111111111111111111111111111111111111111111111111111111111
