111111111111111111111
122222220002222222221
122222220000022222221
122220000000000022221
1222200000E0000022221
122220000000000022221
122222222000000222221
111111111111111111111
