R 600 500
NO ./resources/texture/greystone.xpm
SO ./resources/texture/greystone.xpm
WE ./resources/texture/greystone.xpm
EA ./resources/texture/greystone.xpm
S ./resources/sprite/pillar.xpm
F 100,100,100
C 50,50,50

  1111111111111111 1111       1111 1111111111      111111111111 11111111111
  1200000000000001 1001       1001 1000000001      100000000001 100000000001
  1200200000002001 1001       1001 1000000001      111111111001 1001111110001
  1000011111111111 1001       1001 1000000001              1001 1001     1001
  100001           1001       1001 1000000001         111111001 1001     1001
  10N001           1001       1001 10111111111111     100000001 1001     1001
  100001           1001       1001 100000000000001    111111001 1001     1001
  1002011111111111 1001       1001 100000000000001         1001 1001     1001      
  1000000200000001 100111111111001 100000000000001 111111111001 1001111110001
  1020000000000001 100000000000001 100000000000001 100000000001 100000000001
  1111111111111111 111111111111111 111111111111111 111111111111 11111111111
